amazebot2011maze
--------------------------------------------
--------------------------------------------
--------------------------------------------
---------######-------#################-----
---------------########---------------######
------------------------------------------#-
-----------------------------------------##-
----------------------------------------##--
--------------------------------------###---
----------------------------------#####-----
------------------------------#####---------
---------------------------####-------------
------------------------####----------------
--------------##-########-------------------
-----------###--##--------------------------
----------##--#-----------------------------
---------##---#--------------------------#--
---------#--##--####---------------------#--
---------##----#----#############--------#--
-----------########-----------------#----#--
------------------##########--------#----#--
---------------------------#######--######--
---------------------------------#----------
----------------------------------#---------
----------------------------------##--------
------------------------------####----------
---------------------------####-------------
------------------------####----------------
---------------------####-------------------
---------------------#----------------------
--------------------##----------------------
-------------------##-----------------------
------------------##------------------------
-----------------##-------------------------
----------------##--------------------------
---------------##-------------###########---
-------------##################---------##--
-----------------------------------------#--
--------------------------------------------
-------------------------------------####---
---------------------------------#####------
---------------------------------#----------
---------------------------------#----------
---------------------------------#----------
start = (0,0,EAST)
goal = (37,17)
recharger = (12,15)
